OXOOOXOOOO
OXOXOXOXOX
OXOXOXOXOX
OXOXOXOXOX
OXOXOXOXOX
OXOOOXOXOX
OXOXOXOXOO
OXOXOXOOXO
OXOXOXOXOO
OOOXOOOXXO
